NO ./textures/n_wall.xpm
SO ./textures/s_wall.xpm
WE ./textures/w_wall.xpm
EA ./textures/e_wall.xpm

F 243,198,35
C 244,246,255

1111111111111111111111111111111
1N00000001100000000000000000001
1011000001110000000011111111111
1001000000000000000010000000001
1111111111110000011100000000011
1001101101100000111111111111111
1111111111111101110010001000001
1111011111111101110100001000001
1100000011010101110010001000001
1000100000000000110000001000111
1000100000000000011010100100011
1100110111010101111101111000111
1111111111111111111111111111111